0 1080 1920 1080 1 0 0 100
1920 1080 1920 0 1 0 0 100
0 0 1920 0 1 0 0 100
0 0 0 1080 1 0 0 100
192 972 576 972 1 1 0 100
576 972 576 864 1 1 0 100
576 864 384 864 1 1 0 100
384 864 384 756 1 1 0 100
384 756 192 756 1 1 0 100
192 756 192 972 1 1 0 100
768 972 1152 972 0 1 1 100
1152 972 960 810 0 1 1 100
960 810 768 972 0 1 1 100
1344 972 1728 972 0.87 0.76 0.26 100
1728 972 1728 756 0.87 0.76 0.26 100
1728 756 1536 756 0.87 0.76 0.26 100
1536 756 1536 864 0.87 0.76 0.26 100
1536 864 1344 864 0.87 0.76 0.26 100
1344 864 1344 972 0.87 0.76 0.26 100
192 648 480 540 1 0 1 100
480 540 192 432 1 0 1 100
192 432 192 648 1 0 1 100
864 648 1056 648 0 1 0 100
1056 648 1152 594 0 1 0 100
1152 594 1152 486 0 1 0 100
1152 486 1056 432 0 1 0 100
1056 432 864 432 0 1 0 100
864 432 768 486 0 1 0 100
768 486 768 594 0 1 0 100
768 594 864 648 0 1 0 100
1440 540 1728 648 0 0 0 100
1728 648 1728 432 0 0 0 100
1728 432 1440 540 0 0 0 100
192 108 192 324 0.5 0 1 100
192 324 384 324 0.5 0 1 100
384 324 384 216 0.5 0 1 100
384 216 576 216 0.5 0 1 100
576 216 576 108 0.5 0 1 100
576 108 192 108 0.5 0 1 100
768 108 960 270 1 1 1 100
960 270 1152 108 1 1 1 100
1152 108 768 108 1 1 1 100
1344 108 1344 216 0 0 1 100
1344 216 1536 216 0 0 1 100
1536 216 1536 324 0 0 1 100
1536 324 1728 324 0 0 1 100
1728 324 1728 108 0 0 1 100
1728 108 1344 108 0 0 1 100